11111111111
10010000011
1P0C0000011
10100000011
1C0E0000011
1C110M00011
10000100001
11100111001
11111111111