11111111111
11110000011
1P0C0000011
10100000011
1C0E0000011
1C110000011
11111111111
11111111111
11111111111