1111111111111111111111111111111111111
1111111111111111111111111111111111111
1C01100000010000000001000000000000001
1000100P00001101000100000000000000001
100000000000000000000C000000000000001
1000000000001111100000000000000000001
1000000000000000010101000000000000001
1000000C0000000000000011110000C000001
1000000000000001010000000000000000001
100000000000001011000C000000000111001
1000000000001100010000000000001000111
10C000000000100000000000000000E000C01
1111111111111111111111111111111111111
1111111111111111111111111111111111111