1111111111111111111111111
1000P00000000C00000E00001
1111111111111111111111111
1111111111111000000000001
1111111111111111111111111