1111111111111111111111111
1000P00000000C00000E00001
1000000C000000C000000M001
1111111111111111111111111
1111111111111111111111111
