1111111111111111111111111111111111111111
1M011000000000000E0M000000000000000000M1
1001101111111111111111101101001111111011
100C0000P0000000000111101101100111111011
11011111011011111C00000M0001100000001011
11011111011011111111111100011111110110M1
1101111101100111111111111000000011011011
11M1111101101100000000M00001011011011011
110111110110111111Q011111111011011011011
110111110110000M000000000001011011011011
1000M00001101111111011111001011000000011
1011111101111111111011111111011111111001
101111110110M000111000000011000001111101
1011111101111110111111111011011101111101
1011111100000000000000000011011101111101
1M11111111011111101111111011111101111101
10000000000000000000000000000000000000M1
1111111111111111111111111111111111111111