1111111111111111111111111111111111111
1111111111111111111111111111111111111
1C011QP000010000000001000000000000001
1000100000001101000100000000000000001
100000000000000000000C00000M000000001
1000000000001111100000000000000000001
1000000000000000010101000000000000001
1000000C0000000000000011110000C000001
1000000000000001010000000000000000001
1000000M0000001011000C000000000111001
100000000000110001000000000M001000111
10C00M00000010000000000M000000E000C01
1111111111111111111111111111111111111
1111111111111111111111111111111111111